#####################
#.........#.........#
#.###.###.#.###.###.#
#...................#
#.###.#.#####.#.###.#
#.....#...#...#.....#
#####.### # ###.#####
#####.#       #.#####
#####.# ##_## #.#####
......  #ROP#  ......
#####.# ##### #.#####
#####.#       #.#####
#####.# ##### #.#####
#.........#.........#
#.###.###.#.###.###.#
#...#.....X.....#...#
###.#.#.#####.#.#.###
#.....#...#...#.....#
#.#######.#.#######.#
#...................#
#####################
