_____________________
|.........#.........|
|.###.###.#.###.###.|
|...................|
|.###.#.#####.#.###.|
|.....#...#...#.....|
|####.### # ###.####|
|####.#       #.####|
|####.# ##_## #.####|
<.....  #ROP#  .....>
|####.# ##### #.####|
|####.#       #.####|
|####.# ##### #.####|
|.........#.........|
|.###.###.#.###.###.|
|...#.....X.....#...|
|##.#.#.#####.#.#.##|
|.....#...#...#.....|
|.#######.#.#######.|
|...................|
_____________________