                                                                                                                                                                                                                
                                                                                                                                                                                                                
                                                                                                                                                                                                                
                                                                                                                                                                                                                
                                                                                                                                                                                                                
                                                                                                                                                                                                                
                                                                                                                                                                                                                
                                                                                                                                                                                                                
                                                                                                                                                                                                                
                                                                                                                                                                                                                
                                                W                                                                                                              W                                                
                                     W          W                                                                                                              W          W                                     
                           W         W          W                                                                                                              W          W         W                           
                     W                                                                                                                                                                    W                     
                                                                                           22777777777777777777777722                                                                                           
                                                                                         227777777777777777777777777722                                                                                         
                                                                                       2277777777777777777777777777777722                                                                                       
        W           222222222222222222222222222222                                   22777777777777777777777777777777777722                                   222222222222222222222222222222           W        
    CCCCCCCCCCCCCCCCCCCCCCCCCC                                                       22222222222222222222222222222222222222                                                       CCCCCCCCCCCCCCCCCCCCCCCCCC    
    CCCCC                                                                            22222222222222222222222222222222222222                                                                            CCCCC    
                                                                                        22222222222222222222222222222222                                                                                        
         G  K                                                                           22222222222222222222222222222222                                                                           K  G         
22222222222222 P                                    RRRRRRR                          22222222222222222222222222222222222222                          RRRRRRR                                    P 22222222222222
                                                                                     22222222222222222222222222222222222222                                                                                     
                                                                              Q    222222777777222222222222222222777777222222    Q                                                                              
                                                                                  22222722227222277777777777777222272222722222                                                                                  
              Q                                                                  2877772777722277777222222227777722277772777782                                                                  Q              
                        Q                                                       287777777222277777772CCCCCC277777772222777777782                                                       Q                        
                                              W                                2222222222222222222222CCCCCC2222222222222222222222                                W                                              
                                                                                                       22                                                                                                       
                                                 G                                                     22                                                     G                                                 
             Q  QQQQQRRQQQQQQ            22222222222222222                     22222222222222222222222222222222222222222222222222                     22222222222222222            QQQQQQRRQQQQQ  Q             
                                                                              2877222277277777722227777227777222277777727722227782                                                                              
                                                                             287777777777277272727777722227777727272772777777777782                                                                             
                                                                            28722222222227777777722272277227222777777772222222222782                                                                            
                          2                                                2872277777777722222222222777227772222222222277777777722782                                                2                          
            Q           222                                               287277777777777222222222222772277222222222222777777777772782                                               222           Q            
                       2822                                              28777722222777777272277777777777777777777227277777722222777782                                              2282                       
     G        G G     28222                 K               G           2872222222222222277777772227777227777222777777722222222222222782           G               K                 22282     G G        G     
3333333333333333333333333333333333333333333333333333333333333333333333333333333333333333333333333333333333333333333333333333333333333333333333333333333333333333333333333333333333333333333333333333333333333333
4444444444444444444444444444444444444444444444444444444444444444444444444444444444444444444444444444444444444444444444444444444444444444444444444444444444444444444444444444444444444444444444444444444444444444
